+-+-+-+-+
|   | | |
+-+ + + +
|   |   |
+-+ +-+ +
| |   | |
+ + +-+ +
|       |
+ + + + +
| | | | |
+ +-+ + +
|   | | |
+-+-+-+-+
