+-+-+-+-+-+-+
|   | |     |
+ +-+ + + +-+
| |     | | |
+ + + +-+ + +
|   |   |   |
+ + +-+-+-+ +
| | |   | | |
+-+ + +-+ + +
| |   | | | |
+ + + + + + +
|           |
+-+-+-+-+-+-+
