+-+-+-+-+-+-+-+-+-+-+
| |       |         |
+ + +-+-+-+ +-+-+ +-+
| |       |     |   |
+ + +-+-+-+ +-+ + + +
|   |     |   | | | |
+ + + +-+ +-+ +-+ + +
| | | | |   |   | | |
+-+ + + + + + +-+ + +
|       | | |   | | |
+ + +-+-+-+-+-+-+-+ +
| | |   |   |     | |
+ + + + + +-+ + +-+ +
| | | |       |   | |
+ +-+-+-+-+ + +-+-+ +
| | |   |   |       |
+ + +-+ +-+-+-+ +-+ +
| |     |     | | | |
+ + + +-+ + +-+ + + +
|                   |
+-+-+-+-+-+-+-+-+-+-+
